【国】
ヴィンランド→アメリカ
ニューウィング→カリフォルニア州
火付国→日本
大漢民国→中国
コーリプス→ソ連と北朝鮮
イリウス→ロシア帝国
シラタオ→モンゴル
アレグロ→キューバ
カッタウ→ウイグル
アスガルド→ドイツ 
フラーヴ→フランス
北翼連合→スウェーデン
バードランド→ノルウェー
ウィングランド→ウクライナ
ニヴルヘイム→グリーンランド、アイスランド
翼州連合→イギリス
アクアート→ローマ帝国
アームランド→ブルターニュ
トリプルクアドリアン→ユーゴスラビア
オストアスガルド→オランダ
サウスアスガルド→オーストリア
ビフレスト→スイス
トランプ島→香港
ンリッヒ→エジプト
サンドアイランド→オーストラリア
アトランタ→テキサス州
ソラート→イスラエル
リスター→パレスチナ
フローターランド→ニュージーランド
散菊国→台湾
イッサルト→インドネシア
ハーファ→トルコ
リコチン→カザフスタン
大港国→シンガポール
火アース→ハワイ
バズ→ブラジル
ノースケープ→アルゼンチン
サウスケープ→南アフリカ
エンターランド→イギリス領フォークランド諸島
インザイ、ヲンジュク→千葉県
ハクバ→長野県
ホロベツ、ハイシリナイ→北海道
エッチュウ→富山県
ショルテ帝国→（現実ではないが）神聖ブリタニア帝国
ヴァットアステロイド→ジンバブエ
マツモ島→北方領土
徊猿→樺太
グレートアトランティス→インド
印上、韓民国→韓国

【言語・宗教・人種】
アース語→ドイツ語
サンドアイランド語→ラテン語
漢語→中国語
火付人→日本人
アース教→キリスト教
イーラット教→イスラム教
アース人→ゲルマン人
イーラット人→アラブ人
漢人→中国人
火付語→日本語

【言葉】
〜バズる〜
現実では「話題になる」という意味だが、アリシアでは「バズ調和国にありがちなことをする」という意味で使われる表現。アース人国家で主に使われる言葉。また、バズ調和国は戦争がない平和な国のため、平和な国を指して言うこともある。これを意味する単語は辞書にも登録されている。

【物】
デヴ(Dev)→iPhone
ワイヤード(WIRED)→Android

【企業】
イデア(Idea)→Google
ノート(Note)→Twitter、Facebook
カラフル(Colorful)→LINE

【その他】
シューハル世界記録→ギネス世界記録